########
#1*%%*2#
#*%%%%*#
#%%%%%%#
#%%%%%%#
#*%%%%%#
########
