###############
#1*%%%********#
#*%%%**%%*%*%%#
#%%%%*%%%%%***#
#*%%**%%%%%%%%#
#*%%***%%*%*%%#
#***%%%**%*%**#
#****%%*%%*%**#
#*%%*%%%*%%**2#
###############