#############
#1*%*%%%%%**#
#*#%#%#%#%#*#
#%%%%%%%%%%%#
#%#%#%#%#%#%#
#%%%%%%%%%%%#
#%#%#%#%#%#%#
#%%%%%%%%%%%#
#%#%#%#%#%#%#
#%%%%%%%%%%%#
#*#%#%#%#%#*#
#**%*%*%%%*2#
#############